00,01,02,03,04,01,02,03,04,01,02,05
10,11,12,13,12,13,12,13,12,13,14,15
20,21,17,18,19,19,18,17,19,17,24,25
30,21,19,19,18,17,18,19,19,18,24,35
20,21,08,17,09,19,18,07,08,09,24,25
30,21,19,19,18,17,18,19,19,18,24,35
20,21,17,18,19,19,18,17,19,17,24,25
30,21,19,19,18,17,18,19,19,18,24,35
20,21,22,23,22,23,22,23,22,23,24,25
40,41,42,43,44,41,42,43,44,41,44,45
