00,01,02,03,04,01,02,03,04,01,02,03,04,01,02,03,04,01,02,03,04,01,02,04,05
10,11,12,13,12,13,12,13,12,13,12,13,12,13,12,13,12,13,13,12,13,12,13,14,15
20,21,17,18,19,19,18,17,19,17,17,18,19,19,18,17,19,17,19,18,17,19,17,24,25
30,21,19,19,18,17,18,19,19,18,19,19,18,17,18,19,19,18,17,18,19,19,18,24,35
20,21,08,17,09,19,18,07,08,09,19,08,17,09,19,18,07,19,09,19,18,07,19,24,25
30,21,19,19,18,17,18,19,19,18,19,19,18,17,18,19,19,18,17,18,19,19,18,24,35
20,21,17,18,19,19,18,17,19,17,17,18,19,19,18,17,19,17,19,18,17,19,17,24,25
30,21,19,19,18,17,18,19,19,18,19,19,18,17,18,19,19,18,18,17,18,19,19,24,35
20,21,17,18,19,19,18,17,19,17,17,18,19,19,18,17,19,17,19,18,17,19,17,24,25
30,21,19,19,18,17,18,19,19,18,19,19,18,17,18,19,19,18,17,18,19,19,18,24,35
20,21,08,17,09,19,18,07,08,09,19,08,17,09,19,18,07,19,09,19,18,07,19,24,25
30,21,19,19,18,17,18,19,19,18,19,19,18,17,18,19,19,18,17,18,19,19,18,24,35
20,21,17,18,19,19,18,17,19,17,17,18,19,19,18,17,19,17,19,18,17,19,17,24,25
30,21,19,19,18,17,18,19,19,18,19,19,18,17,18,19,19,18,17,18,19,19,18,24,35
20,21,17,18,19,19,18,17,19,17,17,18,19,19,18,17,19,17,19,18,17,19,17,24,25
30,21,19,19,18,17,18,19,19,18,19,19,18,17,18,19,19,18,17,18,19,19,18,24,35
20,21,08,17,09,19,18,07,08,09,19,08,17,09,19,18,07,19,09,19,18,07,19,24,25
30,21,19,19,18,17,18,19,19,18,19,19,18,17,18,19,19,18,17,18,19,19,18,24,35
20,21,22,23,22,23,22,23,22,23,22,23,22,23,22,23,22,23,22,23,22,23,22,24,25
40,41,42,43,44,41,42,43,44,41,42,43,44,41,42,43,44,41,42,43,44,41,42,44,45

1,1,1,1,1,1,1,1,1,1,1,1,1,1,1,1,1,1,1,1,1,1,1,1,1
1,0,0,0,0,0,0,0,0,0,0,0,0,0,0,0,0,0,0,0,0,0,0,0,1
1,0,0,0,0,0,0,0,0,0,0,0,0,0,0,0,0,0,0,0,0,0,0,0,1
1,0,0,0,0,0,0,0,0,0,0,0,0,0,0,0,0,0,0,0,0,0,0,0,1
1,0,0,0,0,0,0,0,0,0,0,0,0,0,0,0,0,0,0,0,0,0,0,0,1
1,0,0,0,0,0,0,0,0,0,0,0,0,0,0,0,0,0,0,0,0,0,0,0,1
1,0,0,0,0,0,0,0,0,0,0,0,0,0,0,0,0,0,0,0,0,0,0,0,1
1,0,0,0,0,0,0,0,0,0,0,0,0,0,0,0,0,0,0,0,0,0,0,0,1
1,0,0,0,0,0,0,0,0,0,0,0,0,0,0,0,0,0,0,0,0,0,0,0,1
1,0,0,0,0,0,0,0,0,0,0,0,0,0,0,0,0,0,0,0,0,0,0,0,1
1,0,0,0,0,0,0,0,0,0,0,0,0,0,0,0,0,0,0,0,0,0,0,0,1
1,0,0,0,0,0,0,0,0,0,0,0,0,0,0,0,0,0,0,0,0,0,0,0,1
1,0,0,0,0,0,0,0,0,0,0,0,0,0,0,0,0,0,0,0,0,0,0,0,1
1,0,0,0,0,0,0,0,0,0,0,0,0,0,0,0,0,0,0,0,0,0,0,0,1
1,0,0,0,0,0,0,0,0,0,0,0,0,0,0,0,0,0,0,0,0,0,0,0,1
1,0,0,0,0,0,0,0,0,0,0,0,0,0,0,0,0,0,0,0,0,0,0,0,1
1,0,0,0,0,0,0,0,0,0,0,0,0,0,0,0,0,0,0,0,0,0,0,0,1
1,0,0,0,0,0,0,0,0,0,0,0,0,0,0,0,0,0,0,0,0,0,0,0,1
1,0,0,0,0,0,0,0,0,0,0,0,0,0,0,0,0,0,0,0,0,0,0,0,1
1,1,1,1,1,1,1,1,1,1,1,1,1,1,1,1,1,1,1,1,1,1,1,1,1

